BB957BBBB97BBBBBB97B97B97955555555555557
AC2B946A86946A8444544544145555555555557B
ABC28796A9455447BB97BB97C55795555555557A
AABAC14784795551404540455111455555555556
AAC2D2B969547BBEBEBBBEBBBEEC555555555797
AC3ABAC07A97BAABC1440500417955557955556B
ABAC2C3A94454444547BEBEC7C54579554555556
C2ABAD282955579557B878797B95554555795557
BAC2AD2EAC1557C1554050145447B9557954517B
AAD2C3AD2D295514557EBEC11555445556917C16
AABAD2AD2BAABBE9579547BEC1115515556C57C3
AC2AD2C3AAAAAC14556D15457EEC57855515517E
AD2C3AD2AC2AAD055555415555557D0517C17C17
ABAD2AD2AD2AC5295511787BB957978785781787
C2AD2C3AABAABBAABBEC785446956D07817E87C3
BAAD2D2AC2AAC2AAA8797855556957C7E817813A
AAC3AD2AD2AABAAA84787815555451117A87EAAA
AAD2AD2C3AAC2AAA85147EC511117EA87E813AAE
AAD2AD2D2AABAAAAAFC7BFFFAAA817A817AAEA83
AAD2C52D2AC42AAAAFD5057FAAAA87AA87A87AAA
AAD2D52D2AD52AAAAFFFAFFFAAAA83AA87A83AEA
C452D52D42BD42AAC53FAFD52AAAAEAA83AAA87A
D3D2D52D52AD5444552FAFFFAAAA87AAAAAAA87A
D4543D2D5443D5555545017D2AAA83AAAAAAA87A
D5554543D55451555553E8392AAAAAAAAAAAA83A
D55555543D5556BBBD5416EAAAAAEAAAEAAEAEAA
D5555555455555442BBD07D6AAA83AA83A8387AA
D55555555555555544416D552AAAAAAEAAEA83AA
D5555555155555555556D5552AAAAA83A83AEAAA
D555555569555155553BD5512EEAAAAAAAA83AAA
95555555569556D11542BD12ED12AAAAAAAAAAAA
ED551555556D5516ED542D2ED12AEAAAAAAAAAAA
D5556D551555556D5515416D12AA92AAAAAAAAAA
955555556D553BBD3BEBD6D12EEAAAAAAAAAAAAA
ED551555555100010452D552C792AEAAEAAEAAAA
D5556D555556EEEEED501116D12AA9283A83AAAA
91555555555555555556EAED52EEAAAAAAAAAAAA
EED555555555553D3D3D3ED156912EAAAAAAAAAA
D55555555555514545450514792AE92EAAEAAEAA
D5555555555556D555556D6D56EED6C7EC7EC7EE

4,1
20,20
temp(should be the solution to the maze)