BD15555795557BB95555555555557B
ABAB97B94551544411155555555556
AAAAAB86BBBC7B97EEEBB955555557
C2C42845684556A955544455555557
D2BD2A97B85551001111555555557B
BAABA8294457BEEEEEE85155555556
AAC2AEAA95794797957C7855555557
AAD2AD2AC178554105557C79555553
AC3AC3AAD294557E87B9555695117E
AD2AD2AAD2A95517810479556BA817
AD2AD2AABAAA97EBEEC5569116EA87
ABAC3AAC2AA847B85155556E817E83
C2AD2AC3AAA851447C511117A817AA
D2AD2AD2AAAAFC7BFFFAAA83EA83EA
D2AD2AD2AAAAFD5057FAAAA87AA83A
D2C52C542AAAFFFAFFFAAAA83AAEAA
D45543D52AAC53FAFD52AAAAAA87AA
BD3D52BD444552FAFFFAAAAAEA87AA
C52BD42D5555545017D2AAA83A87AA
D5445545555555528392AAAEAA83AA
BD5555555553BBD2EEAAAA83AAEAAA
C5555555555044107D6AAAAAA83AAE
D55555555556D52ED552AEAAAEAA83
95555555155555295512C3AA83AAAA
E95555556D1153EED12C7AAAAAAAAA
D6D55555556ED43BD2ED52AAAAAAAA
D555555155555544147D12EAAAAAAA
95555556D15555556D512C3AAAAAAA
AD55555556D515555112E92AEAAAEA
ED55555555556D5556EED6EC7EEC7E

4,1
15,15
temp(should be the solution to the maze)